NO textures/peach_castle.xpm
EA textures/library.xpm
SO textures/peach_castle2.xpm
WE textures/peach_castle3.xpm
F 136,19,19
C 66,86,229

1111111111111111
1000000000001111
11110000000011111111
1000000111111111
100000E000001111
1000000000001111
1000000000001111
1000000000001111
1111111111111111
