NO textures/peach_castle.xpm
EA textures/library.xpm
SO textures/snow.xpm
WE textures/peach_castle3.xpm
F 136,19,19
C 66,86,229
1111111111111
1000000000001
1111000000001
1000000111111
100000N000001
1000000000001
1000000000001
1000000000001
1111111111111