NO textures/peach_castle.xpm
EA textures/library.xpm
SO textures/snow.xpm
WE textures/peach_castle3.xpm
F 136,19,19
C 66,86,229

1111111111111111
1000000000001111111
111100000000111011011
10000001111111101111
100000E000001111
1000000000001111
1000000000001111
1000000000001111
1111111111111111
