NO textures/peach_castle.xpm
EA textures/library.xpm
SO textures/snow.xpm
WE textures/peach_castle3.xpm
D textures/door_star.xpm
F 136,19,19
C 66,86,229
1111111111111
1000000000001
1111000000001
1000000111111
1000000000001
1111D11110001
1000000010001
1000000010N01
1111111111111