NO textures/peach_castle.xpm
EA textures/library.xpm
SO textures/peach_castle2.xpm
WE textures/peach_castle3.xpm
D textures/door_star.xpm
R textures/bobomb.xpm
Z textures/peachpainting.xpm
F 136,19,19
C 66,86,111
11111111         11111111
1000001          10000001
1000001          10000001
1101111          10000001 
1101Z11111111111111110111
1000000W00000000011110111
 101111111111D110000000001
1000000000000101011111111
101111100000001 1100000001
 110000000001001000111111
11111D111110000001111111111111
     1    10000000001000000110111
111111111111111111111111111111