NO textures/peach_castle2.xpm
EA textures/peach_castle2.xpm
SO textures/peach_castle2.xpm
WE textures/peach_castle2.xpm
D textures/door_star.xpm
R textures/peach_castle2.xpm
G textures/door_star.xpm
F 136,19,19
C 66,86,229

11111111111111111111
1000000D0DDGD0000001
10D0000D0D0000000001
10DDDDDD0D0000000001
100000000DDDDDDDDDD1
1DDDD0000000000000D1
1000D0DDDDDDDDDD00D1
1000D0D00000000D00D1
10DDD0D000D0000D0ND1
11111111111111111111
