NO textures/peach_castle.xpm
EA textures/library.xpm
SO textures/peach_castle2.xpm
WE textures/peach_castle3.xpm
D textures/door_star.xpm
R textures/bobomb.xpm
Z textures/peachpainting.xpm
F 136,19,19
C 66,86,111

11111111          1111111         
 1000001          10000001                      
1000001          100000011111
 1101111          100000000001    
1101Z111111111111111101111111
1000000W00000000011110111     
 101111111111D110000000001              
 10000000011001011111111111          
1011111001 10001 1100000001          
 1100000001010011001111111          
   11111D111110000001111111111111            
     1    10000000001000000110111           
111111111111111111111111111111                      