NO textures/peach_castle.xpm
EA textures/library.xpm
SO textures/peach_castle2.xpm
WE textures/peach_castle3.xpm
D textures/door_star.xpm
R textures/bobomb.xpm
G textures/peachpainting.xpm
F 136,19,19
C 66,86,229

1111G1111111111111
100000001000000001
11111D111000000001
100000000000000001
100000000000000001
100000000000000001
11111D111110000001
10000000001000N001
111111111111111111
