NO textures/peach_castle.xpm
EA textures/library.xpm
SO textures/peach_castle2.xpm
WE textures/peach_castle3.xpm
D textures/door_star.xpm
Z textures/peachpainting.xpm
F 136,19,19
C 66,86,229
P textures/bobomb.xpm
Q textures/spider_painting.xpm
R textures/snow.xpm
S textures/goomba.xpm
T textures/fire.xpm
U textures/boat.xpm
V textures/twhomp.xpm
X textures/mushrooms.xpm

11111111111111Z111
100000001000000001
100000001000000001
10000000111111D111
100000000000000001
100000000000000001
100000000000000001
11111D111110000001
10000000001000N001
111111111111111111


