NO textures/peach_castle3.xpm
EA textures/peach_castle2.xpm
SO textures/library.xpm
WE textures/peach_castle.xpm
D textures/door_star.xpm
Z textures/peachpainting.xpm
F 136,19,19
C 66,86,229
P textures/bobomb.xpm
Q textures/spider_painting.xpm
R textures/snow.xpm
Y textures/goomba.xpm
T textures/fire.xpm
U textures/boat.xpm
V textures/peachpainting.xpm
X textures/bowserpainting.xpm

111111111111111Z111
1000001000001000001
1000001000001000001
11D111111D11111D111
1000100000000000001
1000100000000000001
1000100000000000001
11D1100000000000001
1000000000000000001
1000000000000000001
1111D1111D111111111
1111011110111111111
1111011110111111111
111V0000D0111111111
1111111110111111111
11111111100V1111111
1111111110111111111
111111111N111111111
1111111111111111111
