EA textures/library.xpm
NO textures/peach_castle.xpm
WE textures/peach_castle3.xpm
SO textures/snow.xpm

F 136,19,19
C 1,1,1

1111111111111111
1000000000001111
1000000000001111
1111111111111111
1111111111111111
1000000000001111
1111000000001111111
1000000111111111
100000E00001111
1000000000001101
1111111111111111
