NO textures/peach_castle.xpm
EA textures/library.xpm
SO textures/peach_castle2.xpm
WE textures/peach_castle3.xpm
D textures/door_star.xpm
R textures/bobomb.xpm
Z textures/peachpainting.xpm
F 136,19,19
C 66,86,111

11111111          11111111        
 1000001   1111111110000001                      
1000001      1000000000011111
 1001111     10111100000000001    
11011111111111011111101111111
1000000W00000000011110111111111
 101111111111D11000000000000001         
 100000000110010111110111000001      
1011111001 10001 11000000011111      
 1100000001010011001111111          
   11111D111110000001111111111111            
     1    10000000000000000110111           
111111111111111111111111Z11111                      